

C 0,     71,125
F 94,69,0

NO ./texture/tech_wall1.png
SO ./texture/tech_wall1.png
EA ./texture/tech_wall1.png
WE ./texture/tech_wall1.png



1111111111111111111111111111111111111111111111111111111111
1000000000111111111111111111111111111111111110000000000001
1011000000100000000000010000000000001111111100000000000011
1000000000110000000000000000000000000111111110000000000001          
10110000001000000000000100000000000000000000000000000000011
1001000000000000000000001111111111111111111111111111111111
1011000000100000000000010000000000001111111100000000000011
110000001101010111000000100011111111000111111111111111111
1000100000000000110000001000000000000000000000000000000001111
10000000000000011000111111111111111011010100100011111111111
100000000011000000000000000W000000000111111110000000000001          
1011000000100000000000010000000000001111111100000000000011
1111111111110000011100000000000111111111111111111111111111
100000001 110000000111111111100000000000000111011111111111 
1111011111111101110000000000000000000000000000000000010001
1111011111111101110101001010000000000001111111111111111111
1000000000110000000000000000000000000111111110000000000001          
1011000000100000000000010000000000001111111100000000000011
110000001101000111000000100011111111000111111111111111111
1000100000000000110000001000000000000000000001111
1000000000000001100000000000000000011010100100011
11000001110101011111000000000011110001111111111111111111111
1111011111110101 101111010001111000000000000000000000000111
1111011101111111 111111111111111111111111111111111111111111
1111111111111111111




