NO ./texture/tech_wall1.png
SO ./texture/tech_wall1.png
WE ./texture/tech_wall1.png
EA ./texture/tech_wall3.png

F 209,243,197
C 137,207,240

11111111111111              1111111111111111
11000000000101              11010000000000011
1000000000000111111111111111100100000000011
10000S0000000000000000000000000000000000001111
10000100000001111111        1010010000000001
1100000000000111111110001111111111110000111
10000000000000000000000000000000000000000011
11000000000000000000000000000000000000000011
1000000000000111111111111111111111111111111111
10000111111000000001               1111    111
110001000000011111111111           1   1111  1
10000100000001 1 11111111         11         1
1000010000001111111               11         1
1000011000000000011                1        11
100001111111000011                 11111111111
10000000000001111
11111111111111