NO ./texture/tech_wall3.png
SO ./texture/tech_wall1.png
EA ./texture/tech_wall4.png
WE ./texture/tech_wall2.png

F 220,100,0
C 225,30,0

111111111111111111111111111111
1000000000110000000000001          
1011000001110000000000001        
10010000000000000000000011111111111
111111111111000001110000000000011
100000001 1100000111011111011111 
11110111111111011100000010001
11110111111111011101010010001
11000000110101011100000000001
10001000000000001100000000001
10000000000000001100000000001
1100000111010101000010000N0111
11110111  110101 101111010001111
11111111 1111111 111111111111