NO ./texture/tech_wall3.png
SO ./texture/tech_wall1.png
EA ./texture/tech_wall4.png
WE ./texture/tech_wall2.png

F 220,100,0
C 225,30,0

111111111111111111111111111111111111
1111111111111111000000000110000000000001          
111111111100000001011000001110000000000001   
11111111110010000000001111011111 10
    1111000000011111111111000001110011
    10000001 1100000111011111111111
    11110111111111011100000010001
    000000000100011101010010001
    101000000110101011100000010001
    10001000000000001100000010001
    10000000000000001101010010001
    11000001010101011111011110N0111
    10110111 1110101 101111010001111
    101111111 1111111 111111111111